\\\\\\\\\\\\\\\\\\\\\\\\\\\\\\\\\\\\\\\\\\\\\\\\\\\\\\\\\\\\\\\\\\\\\\\\\\
\\\\\\\\\\\\\\\\\\\\\\\\\\\\\\\\\\\\\\\\\\\\\\\\\\\\\\\\\\\\\\\\\\\\\\\\\\
\\\\\\\\\\\\\\\\\\\\\\\\\\\\\\\\\\\\\\\\\\\\\\\\\\\\\\\\\\\\\\\\\\\\\\\\\\
\\\\\\\\\\\\\\\\\\\\\\\\\\\\\\\\\\\\\\\\\\\\\\\\\\\\\\\\\\\\\\\\\\\\\\\\\\
\\\\\\\\\\\\\\\\\\\\\\\\\\\\\\\\\\\\\\\\\\\\\\\\\\\\\\\\\\\\\\\\\\\\\\\\\\
\\\\\\\\\\\\[//////////////\\===============================|]\\\\\\\\\\\\
\\\\\\\\\\\\[///////////////\\..............................|]\\\\\\\\\\\\
\\\\\\\\\\\\[/////////////\\\\\...............k.............|]\\\\\\\\\\\\
\\\\\\\\\\\\[/////cave/~~\\\\\\.............................|]\\\\\\\\\\\\
\\\\\\\\\\\\[........................*.....................//]\\\\\\\\\\\\
\\\\\\\\\\\\[\=================================\..........///]\\\\\\\\\\\\
\\\\\\\\\\\\[\\\\\\\\\\\\\\\\\\\\\\\\\\\\\\\\\\\..........///]\\\\\\\\\\\\
\\\\\\\\\\\\[\\\\\\\\\\\\\\\\\\\\\\\\\\\\\\\\.........../////]\\\\\\\\\\\\
\\\\\\\\\\\\[\\\\\\\\\\\\\\\\\\\\\\\\\\\\\\\...........//////]\\\\\\\\\\\\
\\\\\\\\\\\\[\\\\\\\\\\\\\\\\\\\\\\\\\\\\\\...........///////]\\\\\\\\\\\\
\\\\\\\\\\\\[\\\\\\\\\\\\\\\\\\\\\\\\\\\\\.........//////////]\\\\\\\\\\\\
\\\\\\\\\\\\[\\\\\\\\\\\\\\\\\\\\\\\\\\.....................|]\\\\\\\\\\\\
\\\\\\\\\\\\[....9..........+...............................|]\\\\\\\\\\\\
\\\\\\\\\\\\[...............................................|]\\\\\\\\\\\\
\\\\\\\\\\\\[===============================================|]\\\\\\\\\\\\
\\\\\\\\\\\\\\\\\\\\\\\\\\\\\\\\\\\\\\\\\\\\\\\\\\\\\\\\\\\\\\\\\\\\\\\\\\
\\\\\\\\\\\\\\\\\\\\\\\\\\\\\\\\\\\\\\\\\\\\\\\\\\\\\\\\\\\\\\\\\\\\\\\\\\
\\\\\\\\\\\\\\\\\\\\\\\\\\\\\\\\\\\\\\\\\\\\\\\\\\\\\\\\\\\\\\\\\\\\\\\\\\
\\\\\\\\\\\\\\\\\\\\\\\\\\\\\\\\\\\\\\\\\\\\\\\\\\\\\\\\\\\\\\\\\\\\\\\\\\
\\\\\\\\\\\\\\\\\\\\\\\\\\\\\\\\\\\\\\\\\\\\\\\\\\\\\\\\\\\\\\\\\\\\\\\\\\
\\\\\\\\\\\\\\\\\\\\\\\\\\\\\\\\\\\\\\\\\\\\\\\\\\\\\\\\\\\\\\\\\\\\\\\\\\
