\\\\\\\\\\\\\\\\\\\\\\\\\\\\\\\\\\\\\\\\\\\\\\\\\\\\\\\\\\\\\\\\\\\\\\\\\\
\\\\\\\\\\\\\\\\\\\\\\\\\\\\\\\\\\\\\\\\\\\\\\\\\\\\\\\\\\\\\\\\\\\\\\\\\\
\\\\\\\\\\\\\\\\\\\\\\\\\\\\\\\\\\\\\\\\\\\\\\\\\\\\\\\\\\\\\\\\\\\\\\\\\\
\\\\\\\\\\\\\\\\\\\\\\\\\\\\\\\\\\\\\\\\\\\\\\\\\\\\\\\\\\\\\\\\\\\\\\\\\\
\\\\\\\\\\\\\\\\\\\\\\\\\\\\\\\\\\\\\\\\\\\\\\\\\\\\\\\\\\\\\\\\\\\\\\\\\\
\\\\\\\\\\\\[//////////////\\===============================|]\\\\\\\\\\\\
\\\\\\\\\\\\[///////////////\\.........................=....|]\\\\\\\\\\\\
\\\\\\\\\\\\[/////////////\\\\\.....====......=====.........|]\\\\\\\\\\\\
\\\\\\\\\\\\[/////cave/~~\\\\\\...........==...........==...|]\\\\\\\\\\\\
\\\\\\\\\\\\[..............*...............................//]\\\\\\\\\\\\
\\\\\\\\\\\\[\=================================\..........///]\\\\\\\\\\\\
\\\\\\\\\\\\[\\\\\\\\\\\\\\\\\\\\\\\\\\\\\\\\\\\..........///]\\\\\\\\\\\\
\\\\\\\\\\\\[\\\\\\\\\\\\\\\\\\\\\\\\\\\\\\\\.........../////]\\\\\\\\\\\\
\\\\\\\\\\\\[\\\\\\\\\\\\\\\\\\\\\\\\\\\\\\\...........//////]\\\\\\\\\\\\
\\\\\\\\\\\\[\\\\\\\\\\\\\\\\\\\\\\\\\\\\\\...........///////]\\\\\\\\\\\\
\\\\\\\\\\\\[\\\\\\\\\\\\\\\\\\\\\\\\\\\\\.........//////////]\\\\\\\\\\\\
\\\\\\\\\\\\[\\\\\\\\\\\\\\\\\\\\\\\\\\.....................|]\\\\\\\\\\\\
\\\\\\\\\\\\[\\\\\\\\\\\\\\......k..........................|]\\\\\\\\\\\\
\\\\\\\\\\\\[\\\\\\\\\\\\\\......=..........................|]\\\\\\\\\\\\
\\\\\\\\\\\\[===============================================|]\\\\\\\\\\\\
\\\\\\\\\\\\\\\\\\\\\\\\\\\\\\\\\\\\\\\\\\\\\\\\\\\\\\\\\\\\\\\\\\\\\\\\\\
\\\\\\\\\\\\\\\\\\\\\\\\\\\\\\\\\\\\\\\\\\\\\\\\\\\\\\\\\\\\\\\\\\\\\\\\\\
\\\\\\\\\\\\\\\\\\\\\\\\\\\\\\\\\\\\\\\\\\\\\\\\\\\\\\\\\\\\\\\\\\\\\\\\\\
\\\\\\\\\\\\\\\\\\\\\\\\\\\\\\\\\\\\\\\\\\\\\\\\\\\\\\\\\\\\\\\\\\\\\\\\\\
\\\\\\\\\\\\\\\\\\\\\\\\\\\\\\\\\\\\\\\\\\\\\\\\\\\\\\\\\\\\\\\\\\\\\\\\\\
\\\\\\\\\\\\\\\\\\\\\\\\\\\\\\\\\\\\\\\\\\\\\\\\\\\\\\\\\\\\\\\\\\\\\\\\\\
