[//////////////\\===============================|]
[///////////////\\..............................|]
[/////////////\\\\\.............................|]
[//////////..\\\\\..............................|]
[..............................................//]
[............................*.................//]
[\=================================\..........///]
[\\\\\\\\\\\\\\\\\\\\\\\\\\\\\\\\\\\..........///]
[\\\\\\\\\\\\\\\\\\\\\\\\\\\\\\\\.........../////]
[\\\\\\\\\\\\\\\\\\\\\\\\\\\\\\\...........//////]
[\\\\\\\\\\\\\\\\\\\\\\\\\\\\\\...........///////]
[\\\\\\\\\\\\\\\\\\\\\\\\\\\\\.........//////////]
[\\\\\\\\\\\\\\\\\\\\\\\\\\.....................|]
[...............................................|]
[...............................................|]
[...............................................|]
[\\\\\\\\\\\\\\\\\\\\\\\\\\\\\\\\\\\\\\\\\\\\\\\\]
